1111111111111
1E001C00111C1
111011101G101
1C001C0011101
1110101110101
1C000000000P1
1111111111111