1111111111111111111111
1E001C001G1C00000G1G01
1110111000000111111001
1C001C00111001000G1011
1110101110100101111001
1C00000G000C00000000P1
1111111111111111111111