11111111111111111111
100000000C1000010001
100111110C0010010E01
100100C1111110010001
1GG10G110G0000111011
100100000000C01000C1
10010000111111101111
100000001G1G00C0C0G1
111101111C1111101111
100000000C00000000P1
11111111111111111111