1111111111111111111111111111111111
1E0000000G00000C00000C0000G0000001
1010010100100G00101001000000010101
1010010010101010001001000G00010101
1P0000000C00C000000G000000000000C1
1E0000000G00000C00000C0000G0000001
1010010100100G00101001000000010101
1010010010101010001001000G00010101
1P0000000C00C000000G000000000000C1
1E0000000G00000C00000C0000G0000001
1010010100100G00101001000000010101
1010010010101010001001000G00010101
1P0000000C00C000000G000000000000C1
1E0000000G00000C00000C0000G0000001
1010010100100G00101001000000010101
1010010010101010001001000G00010101
1P0000000C00C000000G000000000000C1
1E0000000G00000C00000C0000G0000001
1010010100100G00101001000000010101
1010010010101010001001000G00010101
1P0000000C00C000000G000000000000C1
1E0000000G00000C00000C0000G0000001
1010010100100G00101001000000010101
1010010010101010001001000G00010101
1P0000000C00C000000G000000000000C1
1111111111111111111111111111111111
