1111111111111111111111111111111
1E000000G0000000000000000000001
10000000000000000000000G0000001
1000000000000000000000000000001
1000000000000000G00000000000001
10000000000000000000000000G0001
10000000G0000000000000000000001
1000000000000000000000000000001
10000000000000G0000000000000001
1000000000000000000000000G00001
1000000000000000000000000000001
100000G000000000000000000000001
1000000000000000C00000000000001
1000000000000000000000000000001
1000G00000000000000000000000001
1000000000000000000000000G00001
10000000000000000G0000000000001
1000000000000000000000000000001
100000G000000G00000000000000001
1000000000000000000000000000001
10000000000000000G0000000G00001
1000000G00000000000000000000001
100000000000000000000000000CCC1
100000G00000000000000G00000C0P1
1111111111111111111111111111111
