111111111111111111111111111111111111111111111111111111111
100000100000001000000000000000000000000000000000000000001
10E0101011111010000000000GGGGGGGGGGGGGGGGGGGGGGGGGGGGG001
100010001000000000000000000000000000000000000000000000001
1011111000111110000000000GGGGGGGGGGGGGGGGGGGGGGGGGGGGG001
101000101010001000000000000000000000000000000000000000001
1000100010001000000000000GGGGGGGGGGGGGGGGGGGGGGGGGGGGG001
111111111111111000000000000000000000000000000000000000001
100000000000000000000000000000000000000000000000000000001
1000G0000000G000000000000000000000000G000000000000G000001
1000G0000000G000000000000000000000000G000000000000G000001
1000G0000000G000000000000111C11100000G000000000000G000001
1000G0000000G000000000000100000100000G000000000000G000001
1000G0000000G000000000000101110100000G000000000000G000001
1000G0000000G000000000000100P00100000G000000000000G000001
1000G0000000G000000000000101110100000G000000000000G000001
1000G0000000G000000000000100000100000G000000000000G000001
1000G0000000G000000000000111C11100000G000000000000G000001
1000G0000000G000000000000000000000000G000000000000G000001
1000G0000000G000000000000000000000000G000000000000G000001
1000G0000000G000000000000000000000000G000000000000G000001
1000G0000000G000000000000000000000000G000000000000G000001
1000G0000000G000000000000000000000000G000000000000G000001
1000G0000000G000000000000000000000000G000000000000G000001
1000G0000000G000000000000000000000000G000000000000G000001
1000G0000000G000000000000000000000000G000000000000G000001
1000G0000000G000000000000000000000000G000000000000G000001
1000G0000000G000000000000000000000000G000000000000G000001
1000000000000000000000000000000000000000000000000000000C1
111111111111111111111111111111111111111111111111111111111
