111111
1000P1
1C1111
1000E1
111111
