111111
1000P1
101111
1000E1
111111
