111111
100000
101111
100001
111111
1
