1111111111111111111
10001000100000000C1
1010C01000111011101
10111110111C10C1101
1E10001010001001101
11101010C01000C1101
1P10101011101011101
101C1000100C0010001
1010101010111111101
100010C01000000C001
1111111111111111111
1111111111111111111
1111111111111111111
1111111111111111111
1111111111111111111
