1111111
1000001
1011111
1000P01
1111111
