1111111111111111111111111
1000100010C11G000C00G00C1
1010C01000111011101111101
10111110111C10C1101000101
1E100010100010011010101C1
11101010C01000C1101C10101
1P10101011101011101110001
101C1000100C0010001100101
1010101010111111100001101
10G010C0100G000C001101C01
10001000101110000C1101011
1010C0100011101110100G011
10111110111C10C1101001001
101C100010000010001011101
1010101010111111101010101
10001000100000000C100C101
10001110111C1001101111101
10100G1010001001100000001
10101010C01000C110101C101
1010C01000111011101011101
101111101110100C101001111
10111110111C1001101101C01
100C1C001G0000000C0G00001
1111111111111111111111111
