111111111
1E001C001
111011101
10P000001
1111111C1
1C0000001
111111111